1111111111111
100100E0000C1
1000011111001
1P00111000001
100C000011101
1C1110C1111C1
100000000E001
1111101111001
1111101111101
1111101111101
1111101111101
1111111111111
