1111111111111
10010000000C1
1000011111001
1P0011E000001
100C000011101
1C1110C1111C1
1000000000001
1111101111001
1111101111101
1111111111111
